
Single
Vive coi genitori

Divisione spese: uso splitwise
Problemi: ci dimentichiamo di segnare delle spese, se sono state gi√† pagate, manca sempre "l'ultimo euro" quando paghi alla romana
Regalo: nota sul telefono
Quelli che non ti ridanno i soldi: capita ogni tanto, se √® passato molto tempo e sono pochi soldi non vai a spiluccare per 3 euro, se sono di pi√π chiedo

Scenario peggiore: l'euro mancante

(guardare Splitwise !!)
Splitwise: crei un gruppo (es: appartamento), ognuno inserisce le spese e lui calcola le differenze (es: Anna deve 4 euro a Luca)
Problema: devo tenere gli scontrini altrimenti ti dimentichi
Problema scontrini: includono diverse spese, alcune personali, altre da dividere

Gestisci il tuo denaro: ora no, lo gestivo in erasmus perch√© avevo un tot fisso dato dai miei
Come gestisci il tuo denaro: Excel, spese causali categoria, divisione mensile, "non controllo, non faccio grafici o simili, ma se voglio controllare le spese posso andare a farlo"
Problemi: difficile gestione nei prelievi "se prelevo non so dove vanno i soldi"
Ora vorrei farlo, ma non lo faccio pi√π causa eccessivo effort nella parte contanti

Conservi gli scontrini: s√¨, ma non li guardo
Ne faresti a meno: avendo in altro modo la traccia dell'acquisto, rinuncerei allo scontrino cartaceo

Prelievi: ho le commissioni, quindi prelevo somme alte, anche se userei sempre la carta
Ti crea frustrazione prelevare: non molto, vorrei pagare con la carta perch√© √® pi√π comodo
Ti crea fastidio non avere cash in tasca: se non ho la carta s√¨, componente culturale (Mamma: "Ma hai dei soldi in tasca?")
Rinunceresti al contante in un mondo contactless: s√¨

Usi Hype ecc: no
Freelisting:
Hype üëå
N26 üëå
Yapp NO
Satispay NO
In pi√π: un paio di banche

Immagina di essere in vacanza: cerco su Maps gli "atm"

Sai cos'√® il contactless: s√¨
NFC: s√¨
QR: s√¨

Acquisti online: Amazon, Aliexpress
Ebay: diffidenza perch√© una volta √® stata fregata
Altri siti: s√¨, ma prima controllo recensioni ecc per affidabilit√†
Online/offline: 30/70
Online: elettronica
Offline: cose che mi servono subito, cose piccole (es: cartoleria)

Onlinebanking:
Sicurezza: eccessiva e tediosa




